data;mun_id;drs_desc;mun_desc;casos_ativos;suspeitos;em_isol
01/05/2020;3503208;DRS 03 - Araraquara;Araraquara;26;24;50
02/05/2020;3503209;DRS 03 - Araraquara;Araraquara;25;52;77
03/05/2020;3503210;DRS 03 - Araraquara;Araraquara;27;25;52
04/05/2020;3503211;DRS 03 - Araraquara;Araraquara;23;43;66
05/05/2020;3503212;DRS 03 - Araraquara;Araraquara;28;26;54
06/05/2020;3503213;DRS 03 - Araraquara;Araraquara;25;37;62
07/05/2020;3503214;DRS 03 - Araraquara;Araraquara;26;36;62
08/05/2020;3503215;DRS 03 - Araraquara;Araraquara;22;36;58
09/05/2020;3503216;DRS 03 - Araraquara;Araraquara;25;36;61
10/05/2020;3503217;DRS 03 - Araraquara;Araraquara;26;26;52
11/05/2020;3503218;DRS 03 - Araraquara;Araraquara;20;42;62
12/05/2020;3503219;DRS 03 - Araraquara;Araraquara;28;29;57
13/05/2020;3503220;DRS 03 - Araraquara;Araraquara;31;39;70
14/05/2020;3503221;DRS 03 - Araraquara;Araraquara;30;51;81
15/05/2020;3503222;DRS 03 - Araraquara;Araraquara;28;60;88
16/05/2020;3503223;DRS 03 - Araraquara;Araraquara;28;64;92
17/05/2020;3503224;DRS 03 - Araraquara;Araraquara;28;36;64
18/05/2020;3503225;DRS 03 - Araraquara;Araraquara;22;60;82
19/05/2020;3503226;DRS 03 - Araraquara;Araraquara;27;60;87
20/05/2020;3503227;DRS 03 - Araraquara;Araraquara;35;84;119
21/05/2020;3503228;DRS 03 - Araraquara;Araraquara;44;60;104
22/05/2020;3503229;DRS 03 - Araraquara;Araraquara;50;56;106
23/05/2020;3503230;DRS 03 - Araraquara;Araraquara;51;65;116
24/05/2020;3503231;DRS 03 - Araraquara;Araraquara;49;107;156
25/05/2020;3503232;DRS 03 - Araraquara;Araraquara;45;107;152
26/05/2020;3503233;DRS 03 - Araraquara;Araraquara;42;77;119
27/05/2020;3503234;DRS 03 - Araraquara;Araraquara;51;72;123
28/05/2020;3503235;DRS 03 - Araraquara;Araraquara;50;89;139
29/05/2020;3503236;DRS 03 - Araraquara;Araraquara;47;63;110
30/05/2020;3503237;DRS 03 - Araraquara;Araraquara;55;73;128
31/05/2020;3503238;DRS 03 - Araraquara;Araraquara;53;86;139
01/06/2020;3503239;DRS 03 - Araraquara;Araraquara;46;61;107
02/06/2020;3503240;DRS 03 - Araraquara;Araraquara;53;78;131
03/06/2020;3503241;DRS 03 - Araraquara;Araraquara;70;81;151
04/06/2020;3503242;DRS 03 - Araraquara;Araraquara;86;75;161
05/06/2020;3503243;DRS 03 - Araraquara;Araraquara;96;84;180
06/06/2020;3503244;DRS 03 - Araraquara;Araraquara;112;86;198
07/06/2020;3503245;DRS 03 - Araraquara;Araraquara;138;55;193
08/06/2020;3503246;DRS 03 - Araraquara;Araraquara;133;100;233
09/06/2020;3503247;DRS 03 - Araraquara;Araraquara;148;74;222
10/06/2020;3503248;DRS 03 - Araraquara;Araraquara;159;91;250
11/06/2020;3503249;DRS 03 - Araraquara;Araraquara;156;148;304
12/06/2020;3503250;DRS 03 - Araraquara;Araraquara;164;91;255
13/06/2020;3503251;DRS 03 - Araraquara;Araraquara;171;97;268
14/06/2020;3503252;DRS 03 - Araraquara;Araraquara;173;78;251
15/06/2020;3503253;DRS 03 - Araraquara;Araraquara;147;115;262
16/06/2020;3503254;DRS 03 - Araraquara;Araraquara;172;87;259
17/06/2020;3503255;DRS 03 - Araraquara;Araraquara;173;100;273
18/06/2020;3503256;DRS 03 - Araraquara;Araraquara;186;120;306
19/06/2020;3503257;DRS 03 - Araraquara;Araraquara;178;120;298
20/06/2020;3503258;DRS 03 - Araraquara;Araraquara;175;124;299
21/06/2020;3503259;DRS 03 - Araraquara;Araraquara;184;123;307
22/06/2020;3503260;DRS 03 - Araraquara;Araraquara;161;180;341
23/06/2020;3503261;DRS 03 - Araraquara;Araraquara;154;120;274
24/06/2020;3503262;DRS 03 - Araraquara;Araraquara;146;120;266
25/06/2020;3503263;DRS 03 - Araraquara;Araraquara;152;120;272
26/06/2020;3503264;DRS 03 - Araraquara;Araraquara;184;120;304
27/06/2020;3503265;DRS 03 - Araraquara;Araraquara;198;203;401
28/06/2020;3503266;DRS 03 - Araraquara;Araraquara;197;203;400
29/06/2020;3503267;DRS 03 - Araraquara;Araraquara;175;246;421
30/06/2020;3503268;DRS 03 - Araraquara;Araraquara;165;268;433
01/07/2020;3503269;DRS 03 - Araraquara;Araraquara;182;276;458
02/07/2020;3503270;DRS 03 - Araraquara;Araraquara;201;156;357
03/07/2020;3503271;DRS 03 - Araraquara;Araraquara;194;142;336
04/07/2020;3503272;DRS 03 - Araraquara;Araraquara;183;160;343
05/07/2020;3503273;DRS 03 - Araraquara;Araraquara;187;80;267
06/07/2020;3503274;DRS 03 - Araraquara;Araraquara;159;96;255
07/07/2020;3503275;DRS 03 - Araraquara;Araraquara;149;122;271
08/07/2020;3503276;DRS 03 - Araraquara;Araraquara;153;128;281
09/07/2020;3503277;DRS 03 - Araraquara;Araraquara;164;140;304
10/07/2020;3503278;DRS 03 - Araraquara;Araraquara;160;140;300
11/07/2020;3503279;DRS 03 - Araraquara;Araraquara;158;170;328
12/07/2020;3503280;DRS 03 - Araraquara;Araraquara;173;160;333
13/07/2020;3503281;DRS 03 - Araraquara;Araraquara;148;184;332
14/07/2020;3503282;DRS 03 - Araraquara;Araraquara;150;172;322
15/07/2020;3503283;DRS 03 - Araraquara;Araraquara;161;222;383
16/07/2020;3503284;DRS 03 - Araraquara;Araraquara;158;222;380
17/07/2020;3503285;DRS 03 - Araraquara;Araraquara;151;198;349
18/07/2020;3503286;DRS 03 - Araraquara;Araraquara;182;280;462
19/07/2020;3503287;DRS 03 - Araraquara;Araraquara;185;330;515
20/07/2020;3503288;DRS 03 - Araraquara;Araraquara;180;270;450
21/07/2020;3503289;DRS 03 - Araraquara;Araraquara;176;398;574
22/07/2020;3503290;DRS 03 - Araraquara;Araraquara;192;398;590
23/07/2020;3503291;DRS 03 - Araraquara;Araraquara;200;341;541
24/07/2020;3503292;DRS 03 - Araraquara;Araraquara;248;346;594
25/07/2020;3503293;DRS 03 - Araraquara;Araraquara;263;235;498
26/07/2020;3503294;DRS 03 - Araraquara;Araraquara;238;232;470
27/07/2020;3503295;DRS 03 - Araraquara;Araraquara;214;232;446
28/07/2020;3503296;DRS 03 - Araraquara;Araraquara;199;256;455
29/07/2020;3503297;DRS 03 - Araraquara;Araraquara;214;244;458
30/07/2020;3503298;DRS 03 - Araraquara;Araraquara;223;244;467
31/07/2020;3503299;DRS 03 - Araraquara;Araraquara;259;249;508
01/08/2020;3503300;DRS 03 - Araraquara;Araraquara;242;389;631
02/08/2020;3503301;DRS 03 - Araraquara;Araraquara;281;233;514
03/08/2020;3503302;DRS 03 - Araraquara;Araraquara;262;233;495
04/08/2020;3503303;DRS 03 - Araraquara;Araraquara;276;247;523
05/08/2020;3503304;DRS 03 - Araraquara;Araraquara;300;230;530
06/08/2020;3503305;DRS 03 - Araraquara;Araraquara;315;237;552
07/08/2020;3503306;DRS 03 - Araraquara;Araraquara;320;188;508
08/08/2020;3503307;DRS 03 - Araraquara;Araraquara;334;188;522
09/08/2020;3503308;DRS 03 - Araraquara;Araraquara;344;105;449
10/08/2020;3503309;DRS 03 - Araraquara;Araraquara;299;280;579
11/08/2020;3503310;DRS 03 - Araraquara;Araraquara;302;233;535
12/08/2020;3503311;DRS 03 - Araraquara;Araraquara;312;227;539
13/08/2020;3503312;DRS 03 - Araraquara;Araraquara;340;295;635
14/08/2020;3503313;DRS 03 - Araraquara;Araraquara;349;254;603
15/08/2020;3503314;DRS 03 - Araraquara;Araraquara;358;390;748
16/08/2020;3503315;DRS 03 - Araraquara;Araraquara;363;358;721
17/08/2020;3503316;DRS 03 - Araraquara;Araraquara;346;315;661
18/08/2020;3503317;DRS 03 - Araraquara;Araraquara;347;287;634
19/08/2020;3503318;DRS 03 - Araraquara;Araraquara;303;345;648
20/08/2020;3503319;DRS 03 - Araraquara;Araraquara;330;316;646
21/08/2020;3503320;DRS 03 - Araraquara;Araraquara;313;312;625
22/08/2020;3503321;DRS 03 - Araraquara;Araraquara;295;208;503
23/08/2020;3503322;DRS 03 - Araraquara;Araraquara;275;221;496
24/08/2020;3503323;DRS 03 - Araraquara;Araraquara;274;284;558
25/08/2020;3503324;DRS 03 - Araraquara;Araraquara;262;236;498
26/08/2020;3503325;DRS 03 - Araraquara;Araraquara;253;215;468
27/08/2020;3503326;DRS 03 - Araraquara;Araraquara;273;196;469
28/08/2020;3503327;DRS 03 - Araraquara;Araraquara;287;197;484
29/08/2020;3503328;DRS 03 - Araraquara;Araraquara;285;197;482
30/08/2020;3503329;DRS 03 - Araraquara;Araraquara;287;186;473
31/08/2020;3503330;DRS 03 - Araraquara;Araraquara;265;203;468
01/09/2020;3503331;DRS 03 - Araraquara;Araraquara;270;120;390
02/09/2020;3503332;DRS 03 - Araraquara;Araraquara;251;100;351
03/09/2020;3503333;DRS 03 - Araraquara;Araraquara;242;116;358
04/09/2020;3503334;DRS 03 - Araraquara;Araraquara;252;120;372
05/09/2020;3503335;DRS 03 - Araraquara;Araraquara;233;154;387
06/09/2020;3503336;DRS 03 - Araraquara;Araraquara;253;99;352
07/09/2020;3503337;DRS 03 - Araraquara;Araraquara;281;78;359
08/09/2020;3503338;DRS 03 - Araraquara;Araraquara;190;91;281
09/09/2020;3503339;DRS 03 - Araraquara;Araraquara;184;115;299
10/09/2020;3503340;DRS 03 - Araraquara;Araraquara;183;125;308
11/09/2020;3503341;DRS 03 - Araraquara;Araraquara;180;142;322
12/09/2020;3503342;DRS 03 - Araraquara;Araraquara;164;201;365
13/09/2020;3503343;DRS 03 - Araraquara;Araraquara;163;243;406
14/09/2020;3503344;DRS 03 - Araraquara;Araraquara;161;210;371
15/09/2020;3503345;DRS 03 - Araraquara;Araraquara;182;196;378
16/09/2020;3503346;DRS 03 - Araraquara;Araraquara;178;123;301
17/09/2020;3503347;DRS 03 - Araraquara;Araraquara;180;118;298
18/09/2020;3503348;DRS 03 - Araraquara;Araraquara;196;144;340
19/09/2020;3503349;DRS 03 - Araraquara;Araraquara;190;132;322
20/09/2020;3503350;DRS 03 - Araraquara;Araraquara;185;121;306
21/09/2020;3503351;DRS 03 - Araraquara;Araraquara;176;175;351
22/09/2020;3503352;DRS 03 - Araraquara;Araraquara;164;124;288
23/09/2020;3503353;DRS 03 - Araraquara;Araraquara;174;146;320
24/09/2020;3503354;DRS 03 - Araraquara;Araraquara;159;168;327
25/09/2020;3503355;DRS 03 - Araraquara;Araraquara;165;155;320
26/09/2020;3503356;DRS 03 - Araraquara;Araraquara;195;160;355
27/09/2020;3503357;DRS 03 - Araraquara;Araraquara;201;166;367
28/09/2020;3503358;DRS 03 - Araraquara;Araraquara;198;182;380
29/09/2020;3503359;DRS 03 - Araraquara;Araraquara;225;157;382
30/09/2020;3503360;DRS 03 - Araraquara;Araraquara;205;220;425
01/10/2020;3503361;DRS 03 - Araraquara;Araraquara;199;259;458
02/10/2020;3503362;DRS 03 - Araraquara;Araraquara;205;152;357
03/10/2020;3503363;DRS 03 - Araraquara;Araraquara;199;155;354
04/10/2020;3503364;DRS 03 - Araraquara;Araraquara;210;114;324
05/10/2020;3503365;DRS 03 - Araraquara;Araraquara;209;134;343
06/10/2020;3503366;DRS 03 - Araraquara;Araraquara;203;147;350
07/10/2020;3503367;DRS 03 - Araraquara;Araraquara;212;141;353
08/10/2020;3503368;DRS 03 - Araraquara;Araraquara;210;200;410
09/10/2020;3503369;DRS 03 - Araraquara;Araraquara;211;206;417
10/10/2020;3503370;DRS 03 - Araraquara;Araraquara;235;195;430
11/10/2020;3503371;DRS 03 - Araraquara;Araraquara;229;112;341
12/10/2020;3503372;DRS 03 - Araraquara;Araraquara;234;120;354
13/10/2020;3503373;DRS 03 - Araraquara;Araraquara;201;147;348
14/10/2020;3503374;DRS 03 - Araraquara;Araraquara;205;162;367
15/10/2020;3503375;DRS 03 - Araraquara;Araraquara;205;178;383
16/10/2020;3503376;DRS 03 - Araraquara;Araraquara;252;149;401
17/10/2020;3503377;DRS 03 - Araraquara;Araraquara;221;150;371
18/10/2020;3503378;DRS 03 - Araraquara;Araraquara;218;112;330
19/10/2020;3503379;DRS 03 - Araraquara;Araraquara;184;120;304
20/10/2020;3503380;DRS 03 - Araraquara;Araraquara;173;123;296
21/10/2020;3503381;DRS 03 - Araraquara;Araraquara;196;115;311
22/10/2020;3503382;DRS 03 - Araraquara;Araraquara;181;160;341
23/10/2020;3503383;DRS 03 - Araraquara;Araraquara;198;147;345
24/10/2020;3503384;DRS 03 - Araraquara;Araraquara;171;162;333
25/10/2020;3503385;DRS 03 - Araraquara;Araraquara;177;109;286
26/10/2020;3503386;DRS 03 - Araraquara;Araraquara;176;141;317
27/10/2020;3503387;DRS 03 - Araraquara;Araraquara;179;152;331
28/10/2020;3503388;DRS 03 - Araraquara;Araraquara;164;181;345
29/10/2020;3503389;DRS 03 - Araraquara;Araraquara;173;258;431
30/10/2020;3503390;DRS 03 - Araraquara;Araraquara;188;142;330
31/10/2020;3503391;DRS 03 - Araraquara;Araraquara;186;235;421
01/11/2020;3503392;DRS 03 - Araraquara;Araraquara;168;71;239
02/11/2020;3503393;DRS 03 - Araraquara;Araraquara;163;68;231
03/11/2020;3503394;DRS 03 - Araraquara;Araraquara;160;88;248
04/11/2020;3503395;DRS 03 - Araraquara;Araraquara;141;130;271
05/11/2020;3503396;DRS 03 - Araraquara;Araraquara;135;137;272
06/11/2020;3503397;DRS 03 - Araraquara;Araraquara;121;160;281
07/11/2020;3503398;DRS 03 - Araraquara;Araraquara;126;187;313
08/11/2020;3503399;DRS 03 - Araraquara;Araraquara;135;54;189
09/11/2020;3503400;DRS 03 - Araraquara;Araraquara;112;185;297
10/11/2020;3503401;DRS 03 - Araraquara;Araraquara;139;156;295
11/11/2020;3503402;DRS 03 - Araraquara;Araraquara;136;156;292
12/11/2020;3503403;DRS 03 - Araraquara;Araraquara;156;156;312
13/11/2020;3503404;DRS 03 - Araraquara;Araraquara;168;186;354
14/11/2020;3503405;DRS 03 - Araraquara;Araraquara;195;230;425
15/11/2020;3503406;DRS 03 - Araraquara;Araraquara;220;158;378
16/11/2020;3503407;DRS 03 - Araraquara;Araraquara;213;93;306
17/11/2020;3503408;DRS 03 - Araraquara;Araraquara;212;111;323
18/11/2020;3503409;DRS 03 - Araraquara;Araraquara;193;170;363
19/11/2020;3503410;DRS 03 - Araraquara;Araraquara;208;177;385
20/11/2020;3503411;DRS 03 - Araraquara;Araraquara;226;174;400
21/11/2020;3503412;DRS 03 - Araraquara;Araraquara;193;250;443
22/11/2020;3503413;DRS 03 - Araraquara;Araraquara;206;131;337
23/11/2020;3503414;DRS 03 - Araraquara;Araraquara;196;131;327
24/11/2020;3503415;DRS 03 - Araraquara;Araraquara;183;214;397
25/11/2020;3503416;DRS 03 - Araraquara;Araraquara;217;170;387
26/11/2020;3503417;DRS 03 - Araraquara;Araraquara;240;136;376
27/11/2020;3503418;DRS 03 - Araraquara;Araraquara;221;314;535
28/11/2020;3503419;DRS 03 - Araraquara;Araraquara;243;199;442
29/11/2020;3503420;DRS 03 - Araraquara;Araraquara;223;212;435
30/11/2020;3503421;DRS 03 - Araraquara;Araraquara;182;247;429
01/12/2020;3503422;DRS 03 - Araraquara;Araraquara;205;283;488
02/12/2020;3503423;DRS 03 - Araraquara;Araraquara;236;170;406
03/12/2020;3503424;DRS 03 - Araraquara;Araraquara;235;169;404
04/12/2020;3503425;DRS 03 - Araraquara;Araraquara;233;220;453
05/12/2020;3503426;DRS 03 - Araraquara;Araraquara;228;90;318
06/12/2020;3503427;DRS 03 - Araraquara;Araraquara;211;200;411
07/12/2020;3503428;DRS 03 - Araraquara;Araraquara;191;330;521
08/12/2020;3503429;DRS 03 - Araraquara;Araraquara;261;191;452
09/12/2020;3503430;DRS 03 - Araraquara;Araraquara;207;200;407
10/12/2020;3503431;DRS 03 - Araraquara;Araraquara;214;215;429
11/12/2020;3503432;DRS 03 - Araraquara;Araraquara;223;186;409
12/12/2020;3503433;DRS 03 - Araraquara;Araraquara;209;239;448
13/12/2020;3503434;DRS 03 - Araraquara;Araraquara;196;178;374
14/12/2020;3503435;DRS 03 - Araraquara;Araraquara;178;253;431
15/12/2020;3503436;DRS 03 - Araraquara;Araraquara;207;236;443
16/12/2020;3503437;DRS 03 - Araraquara;Araraquara;214;170;384
17/12/2020;3503438;DRS 03 - Araraquara;Araraquara;220;150;370
18/12/2020;3503439;DRS 03 - Araraquara;Araraquara;193;270;463
19/12/2020;3503440;DRS 03 - Araraquara;Araraquara;194;230;424
20/12/2020;3503441;DRS 03 - Araraquara;Araraquara;202;140;342
21/12/2020;3503442;DRS 03 - Araraquara;Araraquara;189;150;339
22/12/2020;3503443;DRS 03 - Araraquara;Araraquara;184;249;433
23/12/2020;3503444;DRS 03 - Araraquara;Araraquara;226;162;388
24/12/2020;3503445;DRS 03 - Araraquara;Araraquara;203;147;350
25/12/2020;3503446;DRS 03 - Araraquara;Araraquara;200;187;387
26/12/2020;3503447;DRS 03 - Araraquara;Araraquara;205;140;345
27/12/2020;3503448;DRS 03 - Araraquara;Araraquara;207;174;381
28/12/2020;3503449;DRS 03 - Araraquara;Araraquara;202;114;316
29/12/2020;3503450;DRS 03 - Araraquara;Araraquara;196;148;344
30/12/2020;3503451;DRS 03 - Araraquara;Araraquara;227;187;414
31/12/2020;3503452;DRS 03 - Araraquara;Araraquara;219;231;450
01/01/2021;3503453;DRS 03 - Araraquara;Araraquara;224;261;485
02/01/2021;3503454;DRS 03 - Araraquara;Araraquara;247;100;347
03/01/2021;3503455;DRS 03 - Araraquara;Araraquara;207;78;285
04/01/2021;3503456;DRS 03 - Araraquara;Araraquara;188;186;374
05/01/2021;3503457;DRS 03 - Araraquara;Araraquara;208;209;417
06/01/2021;3503458;DRS 03 - Araraquara;Araraquara;255;248;503
07/01/2021;3503459;DRS 03 - Araraquara;Araraquara;223;247;470
08/01/2021;3503460;DRS 03 - Araraquara;Araraquara;250;285;535
09/01/2021;3503461;DRS 03 - Araraquara;Araraquara;241;228;469
10/01/2021;3503462;DRS 03 - Araraquara;Araraquara;275;152;427
11/01/2021;3503463;DRS 03 - Araraquara;Araraquara;224;345;569
12/01/2021;3503464;DRS 03 - Araraquara;Araraquara;250;271;521
13/01/2021;3503465;DRS 03 - Araraquara;Araraquara;267;239;506
14/01/2021;3503466;DRS 03 - Araraquara;Araraquara;268;162;430
15/01/2021;3503467;DRS 03 - Araraquara;Araraquara;248;180;428
16/01/2021;3503468;DRS 03 - Araraquara;Araraquara;199;291;490
17/01/2021;3503469;DRS 03 - Araraquara;Araraquara;255;235;490
18/01/2021;3503470;DRS 03 - Araraquara;Araraquara;248;312;560
19/01/2021;3503471;DRS 03 - Araraquara;Araraquara;202;280;482
20/01/2021;3503472;DRS 03 - Araraquara;Araraquara;184;426;610
21/01/2021;3503473;DRS 03 - Araraquara;Araraquara;253;255;508
22/01/2021;3503474;DRS 03 - Araraquara;Araraquara;278;198;476
23/01/2021;3503475;DRS 03 - Araraquara;Araraquara;237;191;428
24/01/2021;3503476;DRS 03 - Araraquara;Araraquara;278;187;465
25/01/2021;3503477;DRS 03 - Araraquara;Araraquara;218;292;510
26/01/2021;3503478;DRS 03 - Araraquara;Araraquara;300;194;494
27/01/2021;3503479;DRS 03 - Araraquara;Araraquara;378;208;586
28/01/2021;3503480;DRS 03 - Araraquara;Araraquara;385;279;664
29/01/2021;3503481;DRS 03 - Araraquara;Araraquara;341;160;501
30/01/2021;3503482;DRS 03 - Araraquara;Araraquara;367;218;585
31/01/2021;3503483;DRS 03 - Araraquara;Araraquara;367;218;585
01/02/2021;3503484;DRS 03 - Araraquara;Araraquara;248;419;667
02/02/2021;3503485;DRS 03 - Araraquara;Araraquara;398;184;582
03/02/2021;3503486;DRS 03 - Araraquara;Araraquara;384;247;631
04/02/2021;3503487;DRS 03 - Araraquara;Araraquara;457;217;674
05/02/2021;3503488;DRS 03 - Araraquara;Araraquara;482;200;682
06/02/2021;3503489;DRS 03 - Araraquara;Araraquara;517;164;681
07/02/2021;3503490;DRS 03 - Araraquara;Araraquara;525;198;723
08/02/2021;3503491;DRS 03 - Araraquara;Araraquara;491;418;909
09/02/2021;3503492;DRS 03 - Araraquara;Araraquara;583;263;846
10/02/2021;3503493;DRS 03 - Araraquara;Araraquara;676;213;889
11/02/2021;3503494;DRS 03 - Araraquara;Araraquara;694;225;919
12/02/2021;3503495;DRS 03 - Araraquara;Araraquara;713;369;1082
13/02/2021;3503496;DRS 03 - Araraquara;Araraquara;698;335;1033
14/02/2021;3503497;DRS 03 - Araraquara;Araraquara;780;189;969
15/02/2021;3503498;DRS 03 - Araraquara;Araraquara;792;288;1080
16/02/2021;3503499;DRS 03 - Araraquara;Araraquara;973;214;1187
17/02/2021;3503500;DRS 03 - Araraquara;Araraquara;1.078;270;1348
18/02/2021;3503501;DRS 03 - Araraquara;Araraquara;1.230;278;1508
19/02/2021;3503502;DRS 03 - Araraquara;Araraquara;1.257;240;1497
20/02/2021;3503503;DRS 03 - Araraquara;Araraquara;1.453;350;1803
21/02/2021;3503504;DRS 03 - Araraquara;Araraquara;1.512;214;1726
22/02/2021;3503505;DRS 03 - Araraquara;Araraquara;1.504;400;1904
23/02/2021;3503506;DRS 03 - Araraquara;Araraquara;1.376;223;1599
24/02/2021;3503507;DRS 03 - Araraquara;Araraquara;1.248;200;1448
25/02/2021;3503508;DRS 03 - Araraquara;Araraquara;1.318;390;1708
26/02/2021;3503509;DRS 03 - Araraquara;Araraquara;1.340;418;1758
27/02/2021;3503510;DRS 03 - Araraquara;Araraquara;1.316;467;1783
28/02/2021;3503511;DRS 03 - Araraquara;Araraquara;1.264;170;1434
01/03/2021;3503512;DRS 03 - Araraquara;Araraquara;1.184;281;1465
02/03/2021;3503513;DRS 03 - Araraquara;Araraquara;1.184;440;1624
03/03/2021;3503514;DRS 03 - Araraquara;Araraquara;1.106;350;1456
04/03/2021;3503515;DRS 03 - Araraquara;Araraquara;1.019;498;1517
05/03/2021;3503516;DRS 03 - Araraquara;Araraquara;897;328;1225
06/03/2021;3503517;DRS 03 - Araraquara;Araraquara;891;412;1303
07/03/2021;3503518;DRS 03 - Araraquara;Araraquara;722;148;870
08/03/2021;3503519;DRS 03 - Araraquara;Araraquara;657;200;857
09/03/2021;3503520;DRS 03 - Araraquara;Araraquara;641;381;1022
10/03/2021;3503521;DRS 03 - Araraquara;Araraquara;635;286;921
11/03/2021;3503522;DRS 03 - Araraquara;Araraquara;576;315;891
12/03/2021;3503523;DRS 03 - Araraquara;Araraquara;562;326;888
13/03/2021;3503524;DRS 03 - Araraquara;Araraquara;553;480;1033
14/03/2021;3503525;DRS 03 - Araraquara;Araraquara;600;156;756
15/03/2021;3503526;DRS 03 - Araraquara;Araraquara;528;207;735
16/03/2021;3503527;DRS 03 - Araraquara;Araraquara;512;330;842
17/03/2021;3503528;DRS 03 - Araraquara;Araraquara;518;409;927
18/03/2021;3503529;DRS 03 - Araraquara;Araraquara;495;515;1010
19/03/2021;3503530;DRS 03 - Araraquara;Araraquara;510;347;857
20/03/2021;3503531;DRS 03 - Araraquara;Araraquara;482;518;1000
21/03/2021;3503532;DRS 03 - Araraquara;Araraquara;490;239;729
22/03/2021;3503533;DRS 03 - Araraquara;Araraquara;445;239;684
23/03/2021;3503534;DRS 03 - Araraquara;Araraquara;403;720;1123
24/03/2021;3503535;DRS 03 - Araraquara;Araraquara;390;461;851
25/03/2021;3503536;DRS 03 - Araraquara;Araraquara;370;430;800
26/03/2021;3503537;DRS 03 - Araraquara;Araraquara;316;444;760
27/03/2021;3503538;DRS 03 - Araraquara;Araraquara;359;156;515
28/03/2021;3503539;DRS 03 - Araraquara;Araraquara;359;156;515
29/03/2021;3503540;DRS 03 - Araraquara;Araraquara;297;224;521
30/03/2021;3503541;DRS 03 - Araraquara;Araraquara;299;289;588
31/03/2021;3503542;DRS 03 - Araraquara;Araraquara;299;230;529
01/04/2021;3503543;DRS 03 - Araraquara;Araraquara;320;151;471
02/04/2021;3503544;DRS 03 - Araraquara;Araraquara;283;198;481
03/04/2021;3503545;DRS 03 - Araraquara;Araraquara;247;162;409
04/04/2021;3503546;DRS 03 - Araraquara;Araraquara;253;113;366
05/04/2021;3503547;DRS 03 - Araraquara;Araraquara;217;111;328
06/04/2021;3503548;DRS 03 - Araraquara;Araraquara;320;269;589
07/04/2021;3503549;DRS 03 - Araraquara;Araraquara;411;236;647
08/04/2021;3503550;DRS 03 - Araraquara;Araraquara;418;231;649
09/04/2021;3503551;DRS 03 - Araraquara;Araraquara;358;254;612
10/04/2021;3503552;DRS 03 - Araraquara;Araraquara;347;163;510
11/04/2021;3503553;DRS 03 - Araraquara;Araraquara;374;129;503
12/04/2021;3503554;DRS 03 - Araraquara;Araraquara;355;104;459
13/04/2021;3503555;DRS 03 - Araraquara;Araraquara;358;369;727
14/04/2021;3503556;DRS 03 - Araraquara;Araraquara;391;385;776
15/04/2021;3503557;DRS 03 - Araraquara;Araraquara;410;425;835
16/04/2021;3503558;DRS 03 - Araraquara;Araraquara;386;396;782
17/04/2021;3503559;DRS 03 - Araraquara;Araraquara;355;379;734
18/04/2021;3503560;DRS 03 - Araraquara;Araraquara;356;258;614
19/04/2021;3503561;DRS 03 - Araraquara;Araraquara;321;171;492
20/04/2021;3503562;DRS 03 - Araraquara;Araraquara;311;368;679
21/04/2021;3503563;DRS 03 - Araraquara;Araraquara;301;319;620
22/04/2021;3503564;DRS 03 - Araraquara;Araraquara;323;328;651
23/04/2021;3503565;DRS 03 - Araraquara;Araraquara;392;349;741
24/04/2021;3503566;DRS 03 - Araraquara;Araraquara;395;309;704
25/04/2021;3503567;DRS 03 - Araraquara;Araraquara;411;178;589
26/04/2021;3503568;DRS 03 - Araraquara;Araraquara;380;100;480
27/04/2021;3503569;DRS 03 - Araraquara;Araraquara;407;349;756
28/04/2021;3503570;DRS 03 - Araraquara;Araraquara;381;349;730
29/04/2021;3503571;DRS 03 - Araraquara;Araraquara;364;417;781
30/04/2021;3503572;DRS 03 - Araraquara;Araraquara;378;418;796
01/05/2021;3503573;DRS 03 - Araraquara;Araraquara;380;99;479
02/05/2021;3503574;DRS 03 - Araraquara;Araraquara;365;175;540
03/05/2021;3503575;DRS 03 - Araraquara;Araraquara;345;228;573
04/05/2021;3503576;DRS 03 - Araraquara;Araraquara;324;308;632
05/05/2021;3503577;DRS 03 - Araraquara;Araraquara;320;320;640
06/05/2021;3503578;DRS 03 - Araraquara;Araraquara;327;431;758
07/05/2021;3503579;DRS 03 - Araraquara;Araraquara;335;602;937
08/05/2021;3503580;DRS 03 - Araraquara;Araraquara;346;651;997
09/05/2021;3503581;DRS 03 - Araraquara;Araraquara;349;311;660
10/05/2021;3503582;DRS 03 - Araraquara;Araraquara;323;190;513
11/05/2021;3503583;DRS 03 - Araraquara;Araraquara;343;526;869
12/05/2021;3503584;DRS 03 - Araraquara;Araraquara;372;539;911
13/05/2021;3503585;DRS 03 - Araraquara;Araraquara;417;577;994
14/05/2021;3503586;DRS 03 - Araraquara;Araraquara;465;565;1030
15/05/2021;3503587;DRS 03 - Araraquara;Araraquara;491;328;819
16/05/2021;3503588;DRS 03 - Araraquara;Araraquara;530;340;870
17/05/2021;3503589;DRS 03 - Araraquara;Araraquara;497;322;819
18/05/2021;3503590;DRS 03 - Araraquara;Araraquara;494;644;1138
19/05/2021;3503591;DRS 03 - Araraquara;Araraquara;541;643;1184
20/05/2021;3503592;DRS 03 - Araraquara;Araraquara;571;796;1367
21/05/2021;3503593;DRS 03 - Araraquara;Araraquara;593;1.003;1596
22/05/2021;3503594;DRS 03 - Araraquara;Araraquara;629;979;1608
23/05/2021;3503595;DRS 03 - Araraquara;Araraquara;667;979;1646
24/05/2021;3503596;DRS 03 - Araraquara;Araraquara;603;686;1289
25/05/2021;3503597;DRS 03 - Araraquara;Araraquara;588;1.177;1765
26/05/2021;3503598;DRS 03 - Araraquara;Araraquara;635;1.017;1652
27/05/2021;3503599;DRS 03 - Araraquara;Araraquara;616;1.564;2180
28/05/2021;3503600;DRS 03 - Araraquara;Araraquara;657;1.561;2218
29/05/2021;3503601;DRS 03 - Araraquara;Araraquara;730;1.571;2301
30/05/2021;3503602;DRS 03 - Araraquara;Araraquara;727;1.571;2298
31/05/2021;3503603;DRS 03 - Araraquara;Araraquara;751;754;1505
01/06/2021;3503604;DRS 03 - Araraquara;Araraquara;788;1.043;1831
02/06/2021;3503605;DRS 03 - Araraquara;Araraquara;808;1.571;2379
03/06/2021;3503606;DRS 03 - Araraquara;Araraquara;821;1.346;2167
04/06/2021;3503607;DRS 03 - Araraquara;Araraquara;953;1.416;2369
05/06/2021;3503608;DRS 03 - Araraquara;Araraquara;943;1.122;2065
06/06/2021;3503609;DRS 03 - Araraquara;Araraquara;973;401;1374
07/06/2021;3503610;DRS 03 - Araraquara;Araraquara;892;516;1408
08/06/2021;3503611;DRS 03 - Araraquara;Araraquara;861;1.038;1899
09/06/2021;3503612;DRS 03 - Araraquara;Araraquara;906;993;1899
10/06/2021;3503613;DRS 03 - Araraquara;Araraquara;1.056;1.030;2086
11/06/2021;3503614;DRS 03 - Araraquara;Araraquara;1.147;746;1893
12/06/2021;3503615;DRS 03 - Araraquara;Araraquara;1.135;604;1739
13/06/2021;3503616;DRS 03 - Araraquara;Araraquara;1.104;450;1554
14/06/2021;3503617;DRS 03 - Araraquara;Araraquara;994;359;1353
15/06/2021;3503618;DRS 03 - Araraquara;Araraquara;920;876;1796
16/06/2021;3503619;DRS 03 - Araraquara;Araraquara;947;758;1705
17/06/2021;3503620;DRS 03 - Araraquara;Araraquara;1.020;585;1605
18/06/2021;3503621;DRS 03 - Araraquara;Araraquara;1.025;661;1686
19/06/2021;3503622;DRS 03 - Araraquara;Araraquara;1.067;638;1705
20/06/2021;3503623;DRS 03 - Araraquara;Araraquara;1.076;235;1311
21/06/2021;3503624;DRS 03 - Araraquara;Araraquara;996;357;1353
22/06/2021;3503625;DRS 03 - Araraquara;Araraquara;1.008;547;1555
23/06/2021;3503626;DRS 03 - Araraquara;Araraquara;1.043;492;1535
24/06/2021;3503627;DRS 03 - Araraquara;Araraquara;1.036;467;1503
25/06/2021;3503628;DRS 03 - Araraquara;Araraquara;1.069;446;1515
26/06/2021;3503629;DRS 03 - Araraquara;Araraquara;1.089;458;1547
27/06/2021;3503630;DRS 03 - Araraquara;Araraquara;1.093;195;1288
28/06/2021;3503631;DRS 03 - Araraquara;Araraquara;1.023;338;1361
29/06/2021;3503632;DRS 03 - Araraquara;Araraquara;1.005;604;1609
30/06/2021;3503633;DRS 03 - Araraquara;Araraquara;1.028;391;1419
01/07/2021;3503634;DRS 03 - Araraquara;Araraquara;1.042;151;1193
02/07/2021;3503635;DRS 03 - Araraquara;Araraquara;1.027;331;1358
03/07/2021;3503636;DRS 03 - Araraquara;Araraquara;1.040;277;1317
04/07/2021;3503637;DRS 03 - Araraquara;Araraquara;1.001;160;1161
05/07/2021;3503638;DRS 03 - Araraquara;Araraquara;940;254;1194
06/07/2021;3503639;DRS 03 - Araraquara;Araraquara;873;426;1299
07/07/2021;3503640;DRS 03 - Araraquara;Araraquara;852;401;1253
08/07/2021;3503641;DRS 03 - Araraquara;Araraquara;826;382;1208
09/07/2021;3503642;DRS 03 - Araraquara;Araraquara;813;375;1188
10/07/2021;3503643;DRS 03 - Araraquara;Araraquara;774;163;937
11/07/2021;3503644;DRS 03 - Araraquara;Araraquara;714;307;1021
12/07/2021;3503645;DRS 03 - Araraquara;Araraquara;826;413;1239
13/07/2021;3503646;DRS 03 - Araraquara;Araraquara;519;441;960
14/07/2021;3503647;DRS 03 - Araraquara;Araraquara;490;455;945
15/07/2021;3503648;DRS 03 - Araraquara;Araraquara;490;505;995
16/07/2021;3503649;DRS 03 - Araraquara;Araraquara;447;427;874
17/07/2021;3503650;DRS 03 - Araraquara;Araraquara;452;489;941
18/07/2021;3503651;DRS 03 - Araraquara;Araraquara;458;304;762
19/07/2021;3503652;DRS 03 - Araraquara;Araraquara;412;446;858
20/07/2021;3503653;DRS 03 - Araraquara;Araraquara;422;452;874
21/07/2021;3503654;DRS 03 - Araraquara;Araraquara;441;410;851
22/07/2021;3503655;DRS 03 - Araraquara;Araraquara;475;398;873
23/07/2021;3503656;DRS 03 - Araraquara;Araraquara;452;452;904
24/07/2021;3503657;DRS 03 - Araraquara;Araraquara;429;350;779
25/07/2021;3503658;DRS 03 - Araraquara;Araraquara;398;145;543
26/07/2021;3503659;DRS 03 - Araraquara;Araraquara;325;264;589
27/07/2021;3503660;DRS 03 - Araraquara;Araraquara;301;391;692
28/07/2021;3503661;DRS 03 - Araraquara;Araraquara;358;333;691
29/07/2021;3503662;DRS 03 - Araraquara;Araraquara;416;273;689
30/07/2021;3503663;DRS 03 - Araraquara;Araraquara;372;199;571
31/07/2021;3503664;DRS 03 - Araraquara;Araraquara;373;245;618
01/08/2021;3503665;DRS 03 - Araraquara;Araraquara;309;114;423
02/08/2021;3503666;DRS 03 - Araraquara;Araraquara;285;229;514
03/08/2021;3503667;DRS 03 - Araraquara;Araraquara;294;135;429
04/08/2021;3503668;DRS 03 - Araraquara;Araraquara;293;209;502
01/01/2021;3553708;DRS 03 - Araraquara;Taquaritinga;12;243;255
02/01/2021;3553708;DRS 03 - Araraquara;Taquaritinga;9;255;264
03/01/2021;3553708;DRS 03 - Araraquara;Taquaritinga;10;255;265
04/01/2021;3553708;DRS 03 - Araraquara;Taquaritinga;19;436;455
05/01/2021;3553708;DRS 03 - Araraquara;Taquaritinga;20;533;553
06/01/2021;3553708;DRS 03 - Araraquara;Taquaritinga;16;544;560
07/01/2021;3553708;DRS 03 - Araraquara;Taquaritinga;44;479;523
08/01/2021;3553708;DRS 03 - Araraquara;Taquaritinga;40;488;528
09/01/2021;3553708;DRS 03 - Araraquara;Taquaritinga;47;438;485
10/01/2021;3553708;DRS 03 - Araraquara;Taquaritinga;51;424;475
11/01/2021;3553708;DRS 03 - Araraquara;Taquaritinga;36;429;465
12/01/2021;3553708;DRS 03 - Araraquara;Taquaritinga;45;379;424
13/01/2021;3553708;DRS 03 - Araraquara;Taquaritinga;43;402;445
14/01/2021;3553708;DRS 03 - Araraquara;Taquaritinga;33;337;370
15/01/2021;3553708;DRS 03 - Araraquara;Taquaritinga;33;410;443
16/01/2021;3553708;DRS 03 - Araraquara;Taquaritinga;33;410;443
17/01/2021;3553708;DRS 03 - Araraquara;Taquaritinga;33;410;443
18/01/2021;3553708;DRS 03 - Araraquara;Taquaritinga;44;458;502
19/01/2021;3553708;DRS 03 - Araraquara;Taquaritinga;61;534;595
20/01/2021;3553708;DRS 03 - Araraquara;Taquaritinga;73;494;567
21/01/2021;3553708;DRS 03 - Araraquara;Taquaritinga;61;544;605
22/01/2021;3553708;DRS 03 - Araraquara;Taquaritinga;105;468;573
23/01/2021;3553708;DRS 03 - Araraquara;Taquaritinga;116;461;577
24/01/2021;3553708;DRS 03 - Araraquara;Taquaritinga;120;460;580
25/01/2021;3553708;DRS 03 - Araraquara;Taquaritinga;96;357;453
26/01/2021;3553708;DRS 03 - Araraquara;Taquaritinga;64;500;564
27/01/2021;3553708;DRS 03 - Araraquara;Taquaritinga;64;609;673
28/01/2021;3553708;DRS 03 - Araraquara;Taquaritinga;82;537;619
29/01/2021;3553708;DRS 03 - Araraquara;Taquaritinga;90;506;596
30/01/2021;3553708;DRS 03 - Araraquara;Taquaritinga;116;446;562
31/01/2021;3553708;DRS 03 - Araraquara;Taquaritinga;134;403;537
01/02/2021;3553708;DRS 03 - Araraquara;Taquaritinga;106;500;606
02/02/2021;3553708;DRS 03 - Araraquara;Taquaritinga;81;608;689
03/02/2021;3553708;DRS 03 - Araraquara;Taquaritinga;97;293;390
04/02/2021;3553708;DRS 03 - Araraquara;Taquaritinga;105;450;555
05/02/2021;3553708;DRS 03 - Araraquara;Taquaritinga;109;267;376
06/02/2021;3553708;DRS 03 - Araraquara;Taquaritinga;117;242;359
07/02/2021;3553708;DRS 03 - Araraquara;Taquaritinga;146;174;320
08/02/2021;3553708;DRS 03 - Araraquara;Taquaritinga;110;327;437
09/02/2021;3553708;DRS 03 - Araraquara;Taquaritinga;120;336;456
10/02/2021;3553708;DRS 03 - Araraquara;Taquaritinga;111;441;552
11/02/2021;3553708;DRS 03 - Araraquara;Taquaritinga;127;432;559
12/02/2021;3553708;DRS 03 - Araraquara;Taquaritinga;144;412;556
13/02/2021;3553708;DRS 03 - Araraquara;Taquaritinga;161;349;510
14/02/2021;3553708;DRS 03 - Araraquara;Taquaritinga;183;308;491
15/02/2021;3553708;DRS 03 - Araraquara;Taquaritinga;137;293;430
16/02/2021;3553708;DRS 03 - Araraquara;Taquaritinga;159;405;564
17/02/2021;3553708;DRS 03 - Araraquara;Taquaritinga;137;332;469
18/02/2021;3553708;DRS 03 - Araraquara;Taquaritinga;180;262;442
19/02/2021;3553708;DRS 03 - Araraquara;Taquaritinga;173;273;446
20/02/2021;3553708;DRS 03 - Araraquara;Taquaritinga;176;269;445
21/02/2021;3553708;DRS 03 - Araraquara;Taquaritinga;198;202;400
22/02/2021;3553708;DRS 03 - Araraquara;Taquaritinga;142;262;404
23/02/2021;3553708;DRS 03 - Araraquara;Taquaritinga;144;301;445
24/02/2021;3553708;DRS 03 - Araraquara;Taquaritinga;159;392;551
25/02/2021;3553708;DRS 03 - Araraquara;Taquaritinga;169;301;470
26/02/2021;3553708;DRS 03 - Araraquara;Taquaritinga;121;257;378
27/02/2021;3553708;DRS 03 - Araraquara;Taquaritinga;158;144;302
28/02/2021;3553708;DRS 03 - Araraquara;Taquaritinga;161;142;303
01/03/2021;3553708;DRS 03 - Araraquara;Taquaritinga;138;228;366
02/03/2021;3553708;DRS 03 - Araraquara;Taquaritinga;126;286;412
03/03/2021;3553708;DRS 03 - Araraquara;Taquaritinga;129;380;509
04/03/2021;3553708;DRS 03 - Araraquara;Taquaritinga;125;324;449
05/03/2021;3553708;DRS 03 - Araraquara;Taquaritinga;133;261;394
06/03/2021;3553708;DRS 03 - Araraquara;Taquaritinga;163;230;393
07/03/2021;3553708;DRS 03 - Araraquara;Taquaritinga;164;230;394
08/03/2021;3553708;DRS 03 - Araraquara;Taquaritinga;166;181;347
09/03/2021;3553708;DRS 03 - Araraquara;Taquaritinga;148;307;455
10/03/2021;3553708;DRS 03 - Araraquara;Taquaritinga;144;350;494
11/03/2021;3553708;DRS 03 - Araraquara;Taquaritinga;154;426;580
12/03/2021;3553708;DRS 03 - Araraquara;Taquaritinga;134;347;481
13/03/2021;3553708;DRS 03 - Araraquara;Taquaritinga;166;218;384
14/03/2021;3553708;DRS 03 - Araraquara;Taquaritinga;174;213;387
15/03/2021;3553708;DRS 03 - Araraquara;Taquaritinga;143;273;416
16/03/2021;3553708;DRS 03 - Araraquara;Taquaritinga;159;320;479
17/03/2021;3553708;DRS 03 - Araraquara;Taquaritinga;125;423;548
18/03/2021;3553708;DRS 03 - Araraquara;Taquaritinga;156;273;429
19/03/2021;3553708;DRS 03 - Araraquara;Taquaritinga;149;408;557
20/03/2021;3553708;DRS 03 - Araraquara;Taquaritinga;167;336;503
21/03/2021;3553708;DRS 03 - Araraquara;Taquaritinga;200;226;426
22/03/2021;3553708;DRS 03 - Araraquara;Taquaritinga;164;271;435
23/03/2021;3553708;DRS 03 - Araraquara;Taquaritinga;147;267;414
24/03/2021;3553708;DRS 03 - Araraquara;Taquaritinga;147;414;561
25/03/2021;3553708;DRS 03 - Araraquara;Taquaritinga;136;423;559
26/03/2021;3553708;DRS 03 - Araraquara;Taquaritinga;140;386;526
27/03/2021;3553708;DRS 03 - Araraquara;Taquaritinga;166;327;493
28/03/2021;3553708;DRS 03 - Araraquara;Taquaritinga;187;200;387
29/03/2021;3553708;DRS 03 - Araraquara;Taquaritinga;139;234;373
30/03/2021;3553708;DRS 03 - Araraquara;Taquaritinga;115;288;403
31/03/2021;3553708;DRS 03 - Araraquara;Taquaritinga;129;272;401
01/04/2021;3553708;DRS 03 - Araraquara;Taquaritinga;109;355;464
02/04/2021;3553708;DRS 03 - Araraquara;Taquaritinga;125;269;394
03/04/2021;3553708;DRS 03 - Araraquara;Taquaritinga;131;269;400
04/04/2021;3553708;DRS 03 - Araraquara;Taquaritinga;147;185;332
05/04/2021;3553708;DRS 03 - Araraquara;Taquaritinga;111;265;376
06/04/2021;3553708;DRS 03 - Araraquara;Taquaritinga;97;325;422
07/04/2021;3553708;DRS 03 - Araraquara;Taquaritinga;99;354;453
08/04/2021;3553708;DRS 03 - Araraquara;Taquaritinga;102;384;486
09/04/2021;3553708;DRS 03 - Araraquara;Taquaritinga;141;220;361
10/04/2021;3553708;DRS 03 - Araraquara;Taquaritinga;154;207;361
11/04/2021;3553708;DRS 03 - Araraquara;Taquaritinga;160;204;364
12/04/2021;3553708;DRS 03 - Araraquara;Taquaritinga;137;356;493
13/04/2021;3553708;DRS 03 - Araraquara;Taquaritinga;131;336;467
14/04/2021;3553708;DRS 03 - Araraquara;Taquaritinga;129;342;471
15/04/2021;3553708;DRS 03 - Araraquara;Taquaritinga;135;284;419
16/04/2021;3553708;DRS 03 - Araraquara;Taquaritinga;148;235;383
17/04/2021;3553708;DRS 03 - Araraquara;Taquaritinga;168;204;372
18/04/2021;3553708;DRS 03 - Araraquara;Taquaritinga;177;198;375
19/04/2021;3553708;DRS 03 - Araraquara;Taquaritinga;172;243;415
20/04/2021;3553708;DRS 03 - Araraquara;Taquaritinga;163;220;383
21/04/2021;3553708;DRS 03 - Araraquara;Taquaritinga;173;209;382
22/04/2021;3553708;DRS 03 - Araraquara;Taquaritinga;153;188;341
23/04/2021;3553708;DRS 03 - Araraquara;Taquaritinga;142;197;339
24/04/2021;3553708;DRS 03 - Araraquara;Taquaritinga;150;197;347
25/04/2021;3553708;DRS 03 - Araraquara;Taquaritinga;170;156;326
26/04/2021;3553708;DRS 03 - Araraquara;Taquaritinga;158;211;369
27/04/2021;3553708;DRS 03 - Araraquara;Taquaritinga;152;223;375
28/04/2021;3553708;DRS 03 - Araraquara;Taquaritinga;146;211;357
29/04/2021;3553708;DRS 03 - Araraquara;Taquaritinga;162;153;315
30/04/2021;3553708;DRS 03 - Araraquara;Taquaritinga;156;249;405
01/05/2021;3553708;DRS 03 - Araraquara;Taquaritinga;160;242;402
02/05/2021;3553708;DRS 03 - Araraquara;Taquaritinga;166;242;408
03/05/2021;3553708;DRS 03 - Araraquara;Taquaritinga;149;236;385
04/05/2021;3553708;DRS 03 - Araraquara;Taquaritinga;186;239;425
05/05/2021;3553708;DRS 03 - Araraquara;Taquaritinga;211;209;420
06/05/2021;3553708;DRS 03 - Araraquara;Taquaritinga;201;196;397
07/05/2021;3553708;DRS 03 - Araraquara;Taquaritinga;217;188;405
08/05/2021;3553708;DRS 03 - Araraquara;Taquaritinga;227;165;392
09/05/2021;3553708;DRS 03 - Araraquara;Taquaritinga;228;167;395
10/05/2021;3553708;DRS 03 - Araraquara;Taquaritinga;216;234;450
11/05/2021;3553708;DRS 03 - Araraquara;Taquaritinga;264;313;577
12/05/2021;3553708;DRS 03 - Araraquara;Taquaritinga;270;352;622
13/05/2021;3553708;DRS 03 - Araraquara;Taquaritinga;311;429;740
14/05/2021;3553708;DRS 03 - Araraquara;Taquaritinga;317;453;770
15/05/2021;3553708;DRS 03 - Araraquara;Taquaritinga;331;426;757
16/05/2021;3553708;DRS 03 - Araraquara;Taquaritinga;336;424;760
17/05/2021;3553708;DRS 03 - Araraquara;Taquaritinga;318;511;829
18/05/2021;3553708;DRS 03 - Araraquara;Taquaritinga;327;630;957
19/05/2021;3553708;DRS 03 - Araraquara;Taquaritinga;358;712;1070
20/05/2021;3553708;DRS 03 - Araraquara;Taquaritinga;385;666;1051
21/05/2021;3553708;DRS 03 - Araraquara;Taquaritinga;429;796;1225
22/05/2021;3553708;DRS 03 - Araraquara;Taquaritinga;442;746;1188
23/05/2021;3553708;DRS 03 - Araraquara;Taquaritinga;449;734;1183
24/05/2021;3553708;DRS 03 - Araraquara;Taquaritinga;408;674;1082
25/05/2021;3553708;DRS 03 - Araraquara;Taquaritinga;405;757;1162
26/05/2021;3553708;DRS 03 - Araraquara;Taquaritinga;429;707;1136
27/05/2021;3553708;DRS 03 - Araraquara;Taquaritinga;459;673;1132
28/05/2021;3553708;DRS 03 - Araraquara;Taquaritinga;498;768;1266
29/05/2021;3553708;DRS 03 - Araraquara;Taquaritinga;512;767;1279
30/05/2021;3553708;DRS 03 - Araraquara;Taquaritinga;530;749;1279
31/05/2021;3553708;DRS 03 - Araraquara;Taquaritinga;520;682;1202
01/06/2021;3553708;DRS 03 - Araraquara;Taquaritinga;553;801;1354
02/06/2021;3553708;DRS 03 - Araraquara;Taquaritinga;532;714;1246
03/06/2021;3553708;DRS 03 - Araraquara;Taquaritinga;545;715;1260
04/06/2021;3553708;DRS 03 - Araraquara;Taquaritinga;560;804;1364
05/06/2021;3553708;DRS 03 - Araraquara;Taquaritinga;576;772;1348
06/06/2021;3553708;DRS 03 - Araraquara;Taquaritinga;578;773;1351
07/06/2021;3553708;DRS 03 - Araraquara;Taquaritinga;475;674;1149
08/06/2021;3553708;DRS 03 - Araraquara;Taquaritinga;518;775;1293
09/06/2021;3553708;DRS 03 - Araraquara;Taquaritinga;536;774;1310
10/06/2021;3553708;DRS 03 - Araraquara;Taquaritinga;513;695;1208
11/06/2021;3553708;DRS 03 - Araraquara;Taquaritinga;508;648;1156
12/06/2021;3553708;DRS 03 - Araraquara;Taquaritinga;517;661;1178
13/06/2021;3553708;DRS 03 - Araraquara;Taquaritinga;528;660;1188
14/06/2021;3553708;DRS 03 - Araraquara;Taquaritinga;428;572;1000
15/06/2021;3553708;DRS 03 - Araraquara;Taquaritinga;462;630;1092
16/06/2021;3553708;DRS 03 - Araraquara;Taquaritinga;454;610;1064
17/06/2021;3553708;DRS 03 - Araraquara;Taquaritinga;356;420;776
18/06/2021;3553708;DRS 03 - Araraquara;Taquaritinga;292;313;605
19/06/2021;3553708;DRS 03 - Araraquara;Taquaritinga;299;309;608
20/06/2021;3553708;DRS 03 - Araraquara;Taquaritinga;298;309;607
21/06/2021;3553708;DRS 03 - Araraquara;Taquaritinga;268;334;602
22/06/2021;3553708;DRS 03 - Araraquara;Taquaritinga;274;379;653
23/06/2021;3553708;DRS 03 - Araraquara;Taquaritinga;267;331;598
24/06/2021;3553708;DRS 03 - Araraquara;Taquaritinga;254;361;615
25/06/2021;3553708;DRS 03 - Araraquara;Taquaritinga;224;322;546
26/06/2021;3553708;DRS 03 - Araraquara;Taquaritinga;226;315;541
27/06/2021;3553708;DRS 03 - Araraquara;Taquaritinga;232;333;565
28/06/2021;3553708;DRS 03 - Araraquara;Taquaritinga;199;293;492
29/06/2021;3553708;DRS 03 - Araraquara;Taquaritinga;187;263;450
30/06/2021;3553708;DRS 03 - Araraquara;Taquaritinga;213;274;487
01/07/2021;3553708;DRS 03 - Araraquara;Taquaritinga;185;267;452
02/07/2021;3553708;DRS 03 - Araraquara;Taquaritinga;194;283;477
03/07/2021;3553708;DRS 03 - Araraquara;Taquaritinga;193;271;464
04/07/2021;3553708;DRS 03 - Araraquara;Taquaritinga;193;271;464
05/07/2021;3553708;DRS 03 - Araraquara;Taquaritinga;189;281;470
06/07/2021;3553708;DRS 03 - Araraquara;Taquaritinga;171;248;419
07/07/2021;3553708;DRS 03 - Araraquara;Taquaritinga;169;246;415
08/07/2021;3553708;DRS 03 - Araraquara;Taquaritinga;189;259;448
09/07/2021;3553708;DRS 03 - Araraquara;Taquaritinga;191;238;429
10/07/2021;3553708;DRS 03 - Araraquara;Taquaritinga;204;249;453
11/07/2021;3553708;DRS 03 - Araraquara;Taquaritinga;205;246;451
12/07/2021;3553708;DRS 03 - Araraquara;Taquaritinga;159;217;376
13/07/2021;3553708;DRS 03 - Araraquara;Taquaritinga;194;302;496
14/07/2021;3553708;DRS 03 - Araraquara;Taquaritinga;187;288;475
15/07/2021;3553708;DRS 03 - Araraquara;Taquaritinga;188;300;488
16/07/2021;3553708;DRS 03 - Araraquara;Taquaritinga;185;273;458
17/07/2021;3553708;DRS 03 - Araraquara;Taquaritinga;186;274;460
18/07/2021;3553708;DRS 03 - Araraquara;Taquaritinga;189;275;464
19/07/2021;3553708;DRS 03 - Araraquara;Taquaritinga;157;231;388
20/07/2021;3553708;DRS 03 - Araraquara;Taquaritinga;176;266;442
21/07/2021;3553708;DRS 03 - Araraquara;Taquaritinga;171;239;410
22/07/2021;3553708;DRS 03 - Araraquara;Taquaritinga;175;248;423
23/07/2021;3553708;DRS 03 - Araraquara;Taquaritinga;173;216;389
24/07/2021;3553708;DRS 03 - Araraquara;Taquaritinga;188;237;425
25/07/2021;3553708;DRS 03 - Araraquara;Taquaritinga;197;271;468
26/07/2021;3553708;DRS 03 - Araraquara;Taquaritinga;169;241;410
27/07/2021;3553708;DRS 03 - Araraquara;Taquaritinga;154;212;366
28/07/2021;3553708;DRS 03 - Araraquara;Taquaritinga;155;253;408
29/07/2021;3553708;DRS 03 - Araraquara;Taquaritinga;156;241;397
30/07/2021;3553708;DRS 03 - Araraquara;Taquaritinga;151;256;407
31/07/2021;3553708;DRS 03 - Araraquara;Taquaritinga;173;266;439
01/08/2021;3553708;DRS 03 - Araraquara;Taquaritinga;174;266;440
02/08/2021;3553708;DRS 03 - Araraquara;Taquaritinga;152;262;414
03/08/2021;3553708;DRS 03 - Araraquara;Taquaritinga;169;242;411
04/08/2021;3553708;DRS 03 - Araraquara;Taquaritinga;166;215;381
25/04/2021;3505906;DRS 13 - Ribeirão Preto;Batatais;240;347;587
26/04/2021;3505906;DRS 13 - Ribeirão Preto;Batatais;243;383;626
27/04/2021;3505906;DRS 13 - Ribeirão Preto;Batatais;256;446;702
28/04/2021;3505906;DRS 13 - Ribeirão Preto;Batatais;285;494;779
29/04/2021;3505906;DRS 13 - Ribeirão Preto;Batatais;335;491;826
30/04/2021;3505906;DRS 13 - Ribeirão Preto;Batatais;394;499;893
01/05/2021;3505906;DRS 13 - Ribeirão Preto;Batatais;411;430;841
02/05/2021;3505906;DRS 13 - Ribeirão Preto;Batatais;437;406;843
03/05/2021;3505906;DRS 13 - Ribeirão Preto;Batatais;436;463;899
04/05/2021;3505906;DRS 13 - Ribeirão Preto;Batatais;461;516;977
05/05/2021;3505906;DRS 13 - Ribeirão Preto;Batatais;497;487;984
06/05/2021;3505906;DRS 13 - Ribeirão Preto;Batatais;535;540;1075
07/05/2021;3505906;DRS 13 - Ribeirão Preto;Batatais;569;610;1179
08/05/2021;3505906;DRS 13 - Ribeirão Preto;Batatais;506;641;1147
09/05/2021;3505906;DRS 13 - Ribeirão Preto;Batatais;535;592;1127
10/05/2021;3505906;DRS 13 - Ribeirão Preto;Batatais;580;552;1132
11/05/2021;3505906;DRS 13 - Ribeirão Preto;Batatais;511;660;1171
12/05/2021;3505906;DRS 13 - Ribeirão Preto;Batatais;467;760;1227
13/05/2021;3505906;DRS 13 - Ribeirão Preto;Batatais;480;731;1211
14/05/2021;3505906;DRS 13 - Ribeirão Preto;Batatais;494;577;1071
15/05/2021;3505906;DRS 13 - Ribeirão Preto;Batatais;509;469;978
16/05/2021;3505906;DRS 13 - Ribeirão Preto;Batatais;507;501;1008
17/05/2021;3505906;DRS 13 - Ribeirão Preto;Batatais;568;548;1116
18/05/2021;3505906;DRS 13 - Ribeirão Preto;Batatais;606;542;1148
19/05/2021;3505906;DRS 13 - Ribeirão Preto;Batatais;628;634;1262
20/05/2021;3505906;DRS 13 - Ribeirão Preto;Batatais;650;614;1264
21/05/2021;3505906;DRS 13 - Ribeirão Preto;Batatais;654;521;1175
22/05/2021;3505906;DRS 13 - Ribeirão Preto;Batatais;636;434;1070
23/05/2021;3505906;DRS 13 - Ribeirão Preto;Batatais;654;463;1117
24/05/2021;3505906;DRS 13 - Ribeirão Preto;Batatais;662;539;1201
25/05/2021;3505906;DRS 13 - Ribeirão Preto;Batatais;639;589;1228
26/05/2021;3505906;DRS 13 - Ribeirão Preto;Batatais;642;537;1179
27/05/2021;3505906;DRS 13 - Ribeirão Preto;Batatais;647;569;1216
28/05/2021;3505906;DRS 13 - Ribeirão Preto;Batatais;641;618;1259
29/05/2021;3505906;DRS 13 - Ribeirão Preto;Batatais;600;584;1184
30/05/2021;3505906;DRS 13 - Ribeirão Preto;Batatais;615;547;1162
31/05/2021;3505906;DRS 13 - Ribeirão Preto;Batatais;542;497;1039
01/06/2021;3505906;DRS 13 - Ribeirão Preto;Batatais;482;486;968
02/06/2021;3505906;DRS 13 - Ribeirão Preto;Batatais;471;509;980
03/06/2021;3505906;DRS 13 - Ribeirão Preto;Batatais;468;498;966
04/06/2021;3505906;DRS 13 - Ribeirão Preto;Batatais;443;566;1009
05/06/2021;3505906;DRS 13 - Ribeirão Preto;Batatais;431;560;991
06/06/2021;3505906;DRS 13 - Ribeirão Preto;Batatais;439;463;902
07/06/2021;3505906;DRS 13 - Ribeirão Preto;Batatais;457;460;917
08/06/2021;3505906;DRS 13 - Ribeirão Preto;Batatais;498;451;949
09/06/2021;3505906;DRS 13 - Ribeirão Preto;Batatais;435;441;876
10/06/2021;3505906;DRS 13 - Ribeirão Preto;Batatais;439;437;876
11/06/2021;3505906;DRS 13 - Ribeirão Preto;Batatais;433;474;907
12/06/2021;3505906;DRS 13 - Ribeirão Preto;Batatais;402;317;719
13/06/2021;3505906;DRS 13 - Ribeirão Preto;Batatais;387;403;790
14/06/2021;3505906;DRS 13 - Ribeirão Preto;Batatais;390;330;720
15/06/2021;3505906;DRS 13 - Ribeirão Preto;Batatais;363;346;709
16/06/2021;3505906;DRS 13 - Ribeirão Preto;Batatais;338;353;691
17/06/2021;3505906;DRS 13 - Ribeirão Preto;Batatais;324;299;623
18/06/2021;3505906;DRS 13 - Ribeirão Preto;Batatais;308;301;609
19/06/2021;3505906;DRS 13 - Ribeirão Preto;Batatais;289;221;510
20/06/2021;3505906;DRS 13 - Ribeirão Preto;Batatais;264;192;456
21/06/2021;3505906;DRS 13 - Ribeirão Preto;Batatais;235;208;443
22/06/2021;3505906;DRS 13 - Ribeirão Preto;Batatais;219;237;456
23/06/2021;3505906;DRS 13 - Ribeirão Preto;Batatais;204;206;410
24/06/2021;3505906;DRS 13 - Ribeirão Preto;Batatais;192;186;378
25/06/2021;3505906;DRS 13 - Ribeirão Preto;Batatais;187;146;333
26/06/2021;3505906;DRS 13 - Ribeirão Preto;Batatais;161;145;306
27/06/2021;3505906;DRS 13 - Ribeirão Preto;Batatais;147;155;302
28/06/2021;3505906;DRS 13 - Ribeirão Preto;Batatais;152;179;331
29/06/2021;3505906;DRS 13 - Ribeirão Preto;Batatais;156;152;308
30/06/2021;3505906;DRS 13 - Ribeirão Preto;Batatais;149;167;316
01/07/2021;3505906;DRS 13 - Ribeirão Preto;Batatais;138;173;311
02/07/2021;3505906;DRS 13 - Ribeirão Preto;Batatais;160;174;334
03/07/2021;3505906;DRS 13 - Ribeirão Preto;Batatais;176;189;365
04/07/2021;3505906;DRS 13 - Ribeirão Preto;Batatais;172;197;369
05/07/2021;3505906;DRS 13 - Ribeirão Preto;Batatais;187;195;382
06/07/2021;3505906;DRS 13 - Ribeirão Preto;Batatais;205;198;403
07/07/2021;3505906;DRS 13 - Ribeirão Preto;Batatais;213;193;406
08/07/2021;3505906;DRS 13 - Ribeirão Preto;Batatais;215;180;395
09/07/2021;3505906;DRS 13 - Ribeirão Preto;Batatais;208;191;399
10/07/2021;3505906;DRS 13 - Ribeirão Preto;Batatais;203;185;388
11/07/2021;3505906;DRS 13 - Ribeirão Preto;Batatais;198;160;358
12/07/2021;3505906;DRS 13 - Ribeirão Preto;Batatais;203;161;364
13/07/2021;3505906;DRS 13 - Ribeirão Preto;Batatais;188;197;385
14/07/2021;3505906;DRS 13 - Ribeirão Preto;Batatais;190;218;408
15/07/2021;3505906;DRS 13 - Ribeirão Preto;Batatais;181;218;399
16/07/2021;3505906;DRS 13 - Ribeirão Preto;Batatais;190;230;420
17/07/2021;3505906;DRS 13 - Ribeirão Preto;Batatais;173;188;361
18/07/2021;3505906;DRS 13 - Ribeirão Preto;Batatais;156;167;323
19/07/2021;3505906;DRS 13 - Ribeirão Preto;Batatais;165;173;338
20/07/2021;3505906;DRS 13 - Ribeirão Preto;Batatais;152;173;325
21/07/2021;3505906;DRS 13 - Ribeirão Preto;Batatais;156;219;375
22/07/2021;3505906;DRS 13 - Ribeirão Preto;Batatais;161;235;396
23/07/2021;3505906;DRS 13 - Ribeirão Preto;Batatais;169;204;373
24/07/2021;3505906;DRS 13 - Ribeirão Preto;Batatais;146;204;350
25/07/2021;3505906;DRS 13 - Ribeirão Preto;Batatais;169;204;373
26/07/2021;3505906;DRS 13 - Ribeirão Preto;Batatais;179;126;305
27/07/2021;3505906;DRS 13 - Ribeirão Preto;Batatais;189;124;313
28/07/2021;3505906;DRS 13 - Ribeirão Preto;Batatais;188;193;381
29/07/2021;3505906;DRS 13 - Ribeirão Preto;Batatais;209;205;414
30/07/2021;3505906;DRS 13 - Ribeirão Preto;Batatais;207;204;411
31/07/2021;3505906;DRS 13 - Ribeirão Preto;Batatais;214;203;417
01/08/2021;3505906;DRS 13 - Ribeirão Preto;Batatais;200;197;397
02/08/2021;3505906;DRS 13 - Ribeirão Preto;Batatais;204;196;400
03/08/2021;3505906;DRS 13 - Ribeirão Preto;Batatais;221;192;413
04/08/2021;3505906;DRS 13 - Ribeirão Preto;Batatais;227;191;418
